*##########################* 
|............##............| 
|.*##*.*###*.##.*###*.*##*.| 
|@*##*.*###*.##.*###*.*##*@| 
|..........................| 
|.*##*.#.*########*.#.*##*.| 
|......#.....##.....#......| 
*####*.####*.##.*####.*####* 
     #.##          ##.#     
     #.#  *~~~~~~*  #.#     
#####*.   |      |   .*##### 
[     .   *~~~~~~*   .     ] 
#####*.              .*##### 
     #.#            #.#    
     #.#            #.#    
*####*.# *########* #.*####* 
|............##............| 
|.####.#####.##.#####.####.| 
|@..##................##..@| 
###.##.#.*########*.#.##.### 
|......#.....##.....#......| 
|......#.....##.....#......| 
|.#########.....##########.| 
|..........................| 
*##########################* 
